- harder house:
3
Eli Brown, Mason Maynard - Jungle Cry (Original Mix).alc
Subb-an - What I Do (Burnski's Tulum Remix).alc
4
The Egg - Walking Away (Tocadisco Remix).alc
Sunny Lax - Enceladus.alc
Zedd - Clarity (Zedd Union Mix).alc
Avicii - Silhouettes (Syn Cole Creamfields Mix).alc
Kaskade vs Martin Garrix - Turn It Down Animals (Kaskade's Paradiso Mash Up).alc
Deadmau5 - Brazil (2nd Edit).alc
Brian Eno - An Ending (Leama & Moor Remix).alc
Kidnap Kid - Vehl.alc
5
Carmen McRae - How Long Has This Been Going On (MJ Cole Remix).alc
Hooverphonic - Plus Profound.alc




- ideas:
10
Elderbrook - How Many Times (Andhim Remix).alc

1
Jeremy Olander - Pinkerton (Finnebassen Remix).alc
Bicep - Aura (12 Mix).alc
Alaska In Winter - Space Eagle.alc
The Temper Trap - Sweet Disposition (Undercatt Remix).alc
Boss Axis - The Punch (Rauschhaus Remix).alc
Tim Green - Eclipse (Original Mix).alc

2
Migos - Bad And Boujee (Zhu Remix).alc

3
Patrice Baumel - Surge.alc
Mathew Jonson & Exercise One - Lost Forever In A Happy Crowd.alc
Miguel Migs - What Do You Want (Rodriguez Jr Remix).alc
Alan Walker - Faded (CH3VY Remix).alc
Lorde - Team (Elephante Remix).alc
Tchami x Janet Jackson - Go Deep.alc
GOTO 1

6
Guy Gerber, Dixon - No Distance (Original Mix).alc
