Bedouin - Set The Controls For The Heart Of The Sun (Original Mix).alc
Rone - Parade (Dominik Eulberg Remix).alc
N'to - Carrousel (Original Mix).alc
Monolink - Burning Sun (DAVI Remix).alc
Roosevelt - Heart (Cleveland Remix).alc
-
Michael Jackson - Thriller.alc
Darlyn Vlys & Forrest - Colours (Tim Engelhardt Remix).alc
Lana Del Rey - Summertime Sadness (Hannes Fischer Nightflight Remix).alc
Einmusik - Night Train (Original Mix).alc
Mind Against - Strange Days (Original Mix).alc
Adana Twins - Strange (Original Mix).alc
Yotto - Cooper's Cup (Original Mix).alc
Bicep - Aura (12 Mix).alc
Jeremy Olander - Pinkerton (Finnebassen Remix).alc
(OMGXthat'sXgood)
Alaska In Winter - Crystal Tears.alc
Avicii - All You Need Is Love.alc
Nora En Pure - True (Lexer Remix).alc
Damian Lazarus & The Ancient Moons - I Found You (Patrice Baumel Remix).alc
Gus Gus - Arabian Horse.alc
Jonas Rathsman - Wolfsbane (Extended Mix).alc
CamelPhat, Elderbrook - Cola (Original Mix).alc
Felix Cartal - Get What You Give (Extended Mix).alc
Alicia Keys - In Common (Black Coffee Remix).alc
-
Mikey Lion & Sabo - Into The Jungle (Lonely Boy's Mighty Jungle Mix).alc
Dave DK - Kronsee (Ulrich Schnauss Mix).alc
Telepopmusik - Breath (Fhin Flip).alc
Route 94 & Jess Glynne - My Love (Original Mix).alc
Ten Walls - Requiem.alc
A Skitzo - Atlantis (Mark Slee Remix).alc
Passion Pit - Sleepyhead (Cerulean City Remix).alc
Purple Disco Machine - Drumatic.alc
Pang - Eye Of The Tiger.alc
Benotmane - Beyond (Karmon Remix).alc
Undercatt - Camargo.alc
Angus & Julia Stone - Big Jet Plane (David Dann Remix).alc
Royksopp & Robyn - Do It Again.alc
Gyptian - Hold Yuh (Major Lazer Remix).alc
Laurent Garnier - The Man With The Red Face (Svek Remix).alc
Stones & Bones - Amahloni (Manoo Remix).alc
Lady Gaga - Telephone (feat. BeyonceÃÅ).alc
Kylie Minogue - Speakerphone.alc
Kidnap Kid - First Light.alc
Darin Epsilon, Philip Chedid - Endless Sands of Time.alc
Jody Wisternoff feat. Sian Evans - The Bridge.alc
Sasha et al. - Smoke Cone.alc
Izzy Bizu - White Tiger (Star Slinger Remix).alc
Bit Funk & Shae Jacobs - Off The Ground (Extended).alc
Cubicolor - Got This Feeling.alc
Justin Martin - Don't Go (Dusky Remix).alc
Oliver Koletski - No Man No Cry (Worakls Remix).alc
Yotto - The Owls.alc
Cracker - Take Me Down to the Infirmary.alc
-
Adana Twins - Strange (Acid Pauli & NU Remix).alc
Freischwimmer - California Dreamin (Acoustic Mix).alc
-
