
Sasha - Channel Deq (Max Cooper Remix).alc
Atish - Peculiar Colors (Lee Jones Remix).alc

Atish - Peculiar Colors.alc
N'to - Starlings (Henry Saiz Remix).alc
Oovation - Falter (Juan Deminicis Remix).alc
Nora En Pure - Driving With Whales (Daniel Portman Remix).alc
Kaskade - Feelin The Night (Acapella).alc
Radiohead - Talk Show Host (Jett Rework).alc
Joshua - Watch Da Bass (Inland Knights Remix).alc
Purple Disco Machine - Walls.alc
Laid Back - Bakerman (Soul Clap Remix).alc
Andhim - Boy Boy Boy (Joris Voorn Remix).alc
Jimpster - Porchlight And Rocking Chairs (KiNK Remix).alc
Jessie Ware - Night Light (Joe Goddard Remix).alc
NVOY - Make You Mine.alc
Don Carlos - Alone (Paradise Version).alc
Jody Wisternoff feat. Sian Evans - The Bridge.alc
Way Out West - Tuesday Maybe.alc
Olivier Giacomotto - Bipolar Star.alc
Yotto - Fire Walk (Original Mix).alc
Worakls - When The Birds Go In The Wrong Way.alc
Booka Shade - Night Falls.alc
Brother Brown - Under The Water (Frankeepella).alc
# HOLY GOD DROP IT ON THAT LAST MARKER (maybe?)
Silicone Soul - Les Nocturnes.alc
DJ Tennis - Chirality (Plaid Remix).alc
Joeski - Kalimba.alc
Eagles & Butterflies - X.alc
Monkey Safari - Walls (Original Mix).alc
Dirk Sid Eno - Morgens In Odonien.alc
? maybe stop here
Doctor Dru - Praerie (Original Mix).alc
John Monkman & Pete Tong - Aurora.alc


???
Matthew Dekay & Lee Burridge - Fur die Liebe.alc
The Chemical Brothers - Wide Open (KoÌˆlsch Remix).alc
Nihils - Not A Man Of Violence (Ghosts Remix).alc
A-Trak - Push (feat. Andrew Wyatt).alc
Tiesto - Lethal Industry (De Hofnar & The Techtives Remix).alc
James Blake - CMYK (eLDOKO Remix).alc

? no this is actually terrible
Dirty Vegas - Days Go By (Joe Maz Remix).alc
# but this is good
Galantis - Smile (Extended Mix).alc
Above & Beyond - Fly To New York (Above & Beyond vs. Jason Ross Club Mix).alc
Feed Me & Crystal Fighters - Love Is All I Got (Original Mix).alc
Kaskade - Eyes (feat. Mindy Gledhill) (Extended Mix).alc
Nero - Reaching Out (Fred Falke Remix).alc
Fun - Some Nights (Cignature Remix Radio Edit).alc
Yeah Yeah Yeahs - Maps (Tommie Sunshine & CID & Modern Machines Remix).alc
Porter Robinson - The Seconds (feat. Jano) (Original Mix).alc
Ce Ce Peniston - Finally (Forever Kid Remix).alc
Adrian Lux - Teenage Crime (Axwell Remix).alc
Krewella - Alive (Cash Cash & Kalkutta Remix).alc
Mat Zo - Lucid Dreams (ilan Bluestone Remix).alc
Mat Zo - Lucid Dream.alc
Lorde - Ribs (Steve James Remix).alc
Lorde - Ribs (Ryan Hemsworth Let's Have A Sleepover Version).alc


# what was this?
# Silicone Soul - Les Nocturnes.alc
DJ Tennis - Chirality (Plaid Remix).alc
Tycho - See.alc
Cassius - I Love You So.alc
Hot Chip - Colours (Fred Falke Remix).alc
Marc Romboy - Elgur.alc
Dubfire & Oliver Huntemann - Fuego (Julian Jeweil Remix).alc
Golden Boy & Miss Kittin - Rippin Kittin (Original Mix).alc
Matthew Dekay & Lee Burridge - Fur die Liebe.alc
Justin Martin - The Sad Piano (Charles Webster Remix).alc
John Monkman & Pete Tong - Aurora.alc
Ryan Davis - Brun (Luca Bacchetti Endless Remix).alc

# Ryan Davis - Brun (Luca Bacchetti Endless Remix).a
TIM & Jerome Steam - Call A Sea (Greenage Remix).alc
Solee - Ten.alc

# Ryan Davis - Brun (Luca Bacchetti Endless Remix).alc
Benny Benassi & John Legend - Dance The Pain Away (Eelke Kleijn Dub).alc
Benny Benassi & John Legend - Dance The Pain Away (Eelke Kleijn Vocal Edit).alc

# Could throw this in?
PTFA - Gornal (Original Upper Mix).alc
The Night VI - Thinking Bout You (Frank Ocean Cover).alc
Thomas Jack - Symphony (Original Mix).alc
Parachute Youth - Can't Get Better Than This (Just Kiddin Remix).alc

# Get these in there:
Joe Goddard - Music Is The Answer (Hot Since 82 Remix).alc
Jan Blomqvist - Dancing People Are Never Wrong (feat The Bianca Story).alc
Rufus - You Were Right.alc
