INXS - Beautiful Girl.alc
Flight Facilities - Crave You (Original Mix).alc
Chris Malinchak - So Good To Me (Original Mix).alc
Fatboy Slim - Praise You (Maribou State Remix).alc
Dave DK - We Mix At Six.alc
Talul - Arythmika.alc
Escenda - Out Of Moves (Kastis Torrau Remix).alc
Robyn - Dancing On My Own (Rex The Dog Extended Remix).alc
Miguel Migs - What Do You Want (Rodriguez Jr Remix).alc
Luca Bacchetti - Atlantic (Original Mix).alc
Mathew Jonson & Exercise One - Lost Forever In A Happy Crowd.alc
Alicia Keys - In Common (Black Coffee Remix).alc
Rodriguez Jr. - Kenopsia (Original Mix).alc
Disclosure & AlunaGeorge - White Noise.alc
Finnebassen - Touching Me.alc
Dickystixxx - Make Me Feel Better (Club Edit).alc
Storm Queen - Look Right Through (MK Vocal Edit).alc
Big Muff - My Funny Valentine (Francois K Body and Soul Mix).alc
Jan Blomqvist - Dancing People Are Never Wrong (feat The Bianca Story).alc
(ohXmyXfuckingXgodXthatXlastXmixXisXgood)
?!!??!?!?!
Nero - Promises (Acapella).als
Pashka - Island Breeze (Trentemoller Mix).alc
Maro Demark - Tiny Dancer (Deadmau5 Vocal Mix).alc
Leonard Cohen - You Want It Darker (Paul Kalkbrenner Remix).alc
Peer Kusiv - Let Her Go.alc
Julius Papp - Ain't No Sunshine.alc



Andain - Beautiful Things (Gabriel and Dresden Unplugged Remix).alc
James Vincent McMorrow - We Don't Eat (Adventure Club Dubstep Remix).alc
Lostep - Burma (Sasha Involver Mix).alc
Andreas Johnson - Glorious (Hybrid Remix).alc
Britney Spears - Till The World Ends (Adventure Club Dubstep Remix).alc
Adventure Club - Need Your Heart.alc
Soul Coughing - Lazybones.alc
Sasha - Wavy Gravy.alc
Imogen Heap - Just For Now (WAV).alc
The Night VI - Thinking Bout You (Frank Ocean Cover).alc
Above & Beyond - Blue Sky Action (Extended Radio Mix).alc


#Xspeculate
Caribou - Can't Do Without You (Lenno Remix).alc
The Chemical Brothers - Wide Open (KoÌˆlsch Remix).alc
The Whitest Boy Alive - Golden Cage (Fred Falke Remix).alc




(TODO)

(you'reXalreadyXatX4)
Robert Miles - Children (Dream Version).alc

Rauschhaus - Purple.alc
Lunar Plane, Ubbah - Apogee.alc
Tim Green - For A Memory.alc
Acid Pauli & Nancy - Ibang.alc
