
-- 116
Jan Blomqvist - Stories Over (Aparde Remix).alc

Nikosf. - A Woman's Nature.alc
R. Fentz - Exile (Canson Remix).alc

Armen Miran - Jojo In The Stars.alc
Mark Ronson - Daffodils (Amtrac & Blu Jemz Night Mix).alc
Damian Lazarus & The Ancient Moons - Vermillion (Agoria Remix).alc

Brian Cid - Hidden (Nico Stojan Remix).alc

N'to - Starlings.alc

Bedouin - Now or Never.alc
Miika Kuisma - Trying My New Wings (Jane Maximova Remix).alc
Mahmut Orhan - Vesaire (Boral Kibil Remix).alc
Frankey & Sandrino - Acamar (Original).alc
Michael Jackson - Man In The Mirror (Peer Kusiv & Rauschhhau Edit).alc
Dirk Sid Eno - Morgens In Odonien.alc

-- Lake People!
Kollektiv Turmstrasse - Ordinary (Lake People's Circle Motive Remix).alc
BT - Remember (Acapella).als
Solee - Ten.alc

C. Vogt - Purple Hills (YokoO Remix).alc
N'to - Starlings (Henry Saiz Remix).alc
Booka Shade - In White Rooms (Jonas Rathsman Reprise).alc
Session Victim - Matching Half.alc
Lindstrom - Closing Shot.alc
Nufrequency - Go That Deep (Charles Webster Remix).alc
Rufus - Like An Animal (Yotto Remix).alc
Justin Martin - Don't Go (Dusky Remix).alc

- also good:
Depeche Mode - Dream On (Bushwacka Tough Guy Mix).alc

House Of Dad - Roof Metal Corrosion

Sam Feldt - Show Me Love (EDX Indian Summer Remix).alc

Ryan Davis - Brun (Luca Bacchetti Endless Remix).alc

Djuma Soundsystem - Les Djinns (Trentemoller Remix).alc
Jon Hopkins - Open Eye Signal (Nosaj Thing Remix).alc
Matthew Dekay & Lee Burridge - Fur die Liebe.alc

Justin Martin - The Sad Piano (Charles Webster Remix).alc
