Paul Kalkbrenner - Aaron (Ted & Francis Vocal Version).alc
James Hersey - Coming Over (Filous Remix).alc
Kanye West - Bound 2 (Solidisco Remix).alc
Sigma - Nobody to Love (Sigma's Future Jungle Mix).alc
Porter Robinson - Sad Machine.alc
EMBRZ - Slow Down.alc
Nina Simone - Black Is The Color Of My True Loves Hair (Jaffa Remix).alc
Chvrches - Recover.alc
Sam Smith - Stay With Me.alc
Sam Smith - Stay With Me (Throttle Remix).alc
Clean Bandit - Rather Be (Elephante Remix).alc
Avicii - All You Need Is Love.alc
Avicii - Penguin (Fade Into Darkness) (Vocal Club Mix).alc
Chvrches - Clearest Blue.alc
Irfane & Outlines - Just a Little Lovin'.alc
Juun & Sam Smith - When It's Alright (Extended).alc
Mr Probz - Waves (Robin Schulz Remix).alc
Joris Voorn - Ringo.alc
Zedd - Stay The Night (Acapella).als
Zedd & Foxes - Clarity (Acapella).als
Laurent Garnier - The Man With The Red Face (Svek Remix).alc
Ultraista - Smalltalk (Four Tet Remix).alc
Rodriguez Jr. - Kenopsia (Original Mix).alc
Sasha & Polica - Out Of Time.alc
Flight Facilities - Clair De Lune (Motez Remix).alc
Dusky - Skin Deep (Global Communication Remix).alc
Purity Ring - Repetition.alc
KiNK - Cloud Generator.alc
Phoebe Ryan - Mine (Elephante Remix Extended).alc
NVOY - Make You Mine.alc

###
Naxxos - Anyama.alc
Felix Jaehn & Freddy Verano & Linying - Shine (Extended Mix).alc
St Germain - So Flute (Mozambo Remix).alc
Joe Goddard - Music Is The Answer (Hot Since 82 Remix).alc
Monkey Safari - Dodge (Victor Ruiz Remix).alc
Damian Lazarus & The Ancient Moons - I Found You (Patrice Baumel Remix).alc
Miguel Migs - What Do You Want (Rodriguez Jr Remix).alc
The Fugees - Ready Or Not (DubRocca Remix).alc
Tchami x Janet Jackson - Go Deep.alc
Boys Noize - Oh (A-Trak Remix).alc
Splittr - All Alone (Extended Vocal Mix).alc
Everything But The Girl - Lullaby Of Clubland.als
Gus Gus - David (Tim Deluxe Remix).alc
Justice - D.A.N.C.E. (MSTRKRFT Remix).alc
Michael Jackson - PYT (Pretty Young Thing).alc
Moony - Dove (I'll Be Loving You) (T&F vs. Moltosugo Radio Mix).alc
Daft Punk - Digital Love.alc
