Elderbrook - How Many Times (Andhim Remix).alc
Solee - Ten.alc
Stephan Bodzin - Powers Of Ten (Gabriel Ananda Remix).alc
Fatboy Slim - Sunset (Bird of Prey) (Spieltape Remix).alc
Matthew Dekay & Lee Burridge - Lost In A Moment.alc
Van Did, Lox D - Elena (Teho Remix).alc

# fresh
Elderbrook - How Many Times (Andhim Remix).alc
The XX - Crystalised (Rory Phillips Mix).alc
Doctor Dru - Praerie (Original Mix).alc
Eagles & Butterflies - X.alc
Fabio Giannelli - Canvas (Solee Remix).alc
Michael Jackson - Man In The Mirror (Peer Kusiv & Rauschhhau Edit).alc
Monolink - Burning Sun (DAVI Remix).alc
Mano Le Tough - Primative People (Tale Of Us Remix).alc

#XandXfreshXagain
Avicii - Levels (Original Mix).alc
Project 46 - Faces.alc
Orbital - Halcyon + On + On.alc
Sigur Ros - Svefn-g-englar (Innerstate Mix).alc
Ross From Friends - Talk To Me You'll Understand.alc
Lorde - Ribs (Ryan Hemsworth Let's Have A Sleepover Version).alc
Silversun Pickups - Lazy Eye (Jason Bentley Remix).alc
Mini Viva - Left My Heart In Tokyo (Fred Falke Dub Mix).alc
U2 - New Years Day (Electro Remix).alc
Foals - My Number (Totally Enormous Extinct Dinosaurs Remix).alc
Royksopp - Poor Leno (Sander Kleinenberg Northern Beach Mix).alc
Deep House Soldiers - In My Bag.alc
Nicolas Jaar - El Bandido (Original Mix).alc
CamelPhat, Elderbrook - Cola (Original Mix).alc
Royksopp - Poor Leno (Album Version).alc
Ratatat - Drugs.alc
Miguel Migs - What Do You Want (Rodriguez Jr Remix).alc
Mikey Lion & Sabo - Into The Jungle (Lonely Boy's Mighty Jungle Mix).alc
Juun & Sam Smith - When It's Alright (Extended).alc
Corona - Rhythm Of the Night (Hotel Garuda Remix).alc
Eelke Kleijn - The Voices.alc
Quivver - Takin Over.alc
Matthias Vogt - World Needs Its Dreamers (World Padapella).als
