
Kollektiv Turmstrasse - Ordinary (Lake People's Circle Motive Remix).alc
Michael Jackson - Man In The Mirror (Peer Kusiv & Rauschhhau Edit).alc
Olderic & Peter Pardeike - Connaisseur.alc
---
Saigon Kick - Love Is On The Way.alc
Orbital - Halcyon + On + On.alc
Project 46 - Faces.alc
---
Maxxi Soundsystem - In The Woods (Original Mix).alc
Florence And The Machine - Spectrum Say My Name (Acapella).als
John Monkman & Pete Tong - Aurora.alc
---
Rampue - Leporidae (Original Mix).alc
Yeah Yeah Yeahs - Hysteric (Acoustic Version).alc
Downtown Party Network - Space Me Out (Ewan Pearson Remix).alc
Chaos In The CBD - Midnight In Peckham.alc
DIMMI - Promesses (Slow Instrumental Version).alc
Aparde - Varia (Original Mix).alc
Ciano - Erode (Original Mix).alc
Rodriguez Jr. - Mistral (Original Mix).alc
---
Tim Engelhardt - Kissing Your Eyes (Andre Hommen Remix).alc
Solee - Jule.alc
Stones & Bones - Amahloni (Manoo Remix).alc
Groove Armada - At The River (Eat More Cake Remix).alc
Behrouz - Where Are You Now.alc
Octo Octa - Adrift (Dorisburg Remix).alc
Joris Voorn - DM12 (Original Mix).alc
Peggy Gou - It Makes You Forget (Itgehane) (Original Mix).alc
PTFA - Gornal (Original Upper Mix).alc
Groove Armada - My Friend (Kav Verhouzer & IJsbrand on Sax Sunset Edit).alc
Adam K & Soha - Twilight (Chris Barratt Remix).alc
Eric Prydz - Every Day (Original Mix).alc
Oceanlab - Another Chance (Above & Beyond Club Mix).alc
Reflekt - Need To Feel Loved (Adam K & Soha Vocal Mix).alc
Circulation - Turquoise (differentGear Remix).alc
Hot Chip - Flutes (Sasha Remix).alc
Daughter - Youth (Alle Farben Remix).alc
Beyonce - XO (Monsieur Adi Remix).alc
Pete Heller - Big Love (The Dronez Mix).alc
The Doors - Hello, I Love You (Freeland Radio Edit) (no scream).alc
Elastic Reality - Cassa De X (Osamu M Remix).alc
Slam - This World (Slam Instrumental).alc
Andain - Beautiful Things (Gabriel and Dresden Unplugged Remix).alc
Arty - Kate (2015 Remix).alc
Porter Robinson - The Seconds (feat. Jano) (Original Mix).alc
The Chemical Brothers - Wide Open (By the Light of the Moon Mix).alc
The Chemical Brothers - Wide Open (KoÌˆlsch Remix).alc
Peer Kusiv - Let Her Go.alc
UNKLE vs Petter - What Are You To Me (Sashas Involver Remix).alc
Blunted Dummies - House for All (Ruede Hagelstein Ecstatic Dub).alc
Eagles & Butterflies - X.alc
Doctor Dru - Praerie (Original Mix).alc
Mark Alow - Golden Tiger (Original).alc
Fatboy Slim - Sunset (Bird of Prey) (Spieltape Remix).alc
---
Eekkoo & Sailor & I - Letters (Lower Case) (Doctor Dru Remix).alc
Alex Dimou & Black Soda - This Time.alc
---
Death on the Balcony - Solar Lives (DOTB Mix).alc
Kollektiv Turmstrasse - Ordinary (Lake People's Circle Motive Remix).alc
Modd - Guron (Original Mix).alc
Olderic & Peter Pardeike - Connaisseur.alc
Rone - Parade (Dominik Eulberg Remix).alc
Sasha - Vapour Trails (Kiasmos Remix).alc
Luttrell - Good Day.alc
Blunted Dummies - House for All (Ruede Hagelstein Ecstatic Dub).alc
Pascal Schumacher, Maxime Delpierre - Drips (Stimming Remix).alc
Jan Blomqvist - Back In The Taxi (Original Mix).alc
---
CHVRCHES - Clearest Blue (Gryffin Remix).alc
Unclubbed & Kim Wayman - We Are The People.alc
Hal Incandenza - Ventura (Dub Version).alc
Cruzo - Epic Sax Guy (Cruzo Remix).alc
Switchdance - O Amolador (Original Mix).alc
Fatima Yamaha - What's a Girl to Do.alc
Kora (CA) - Caddo (Original).alc
Nina Simone - Here Comes The Sun (Francois K Remix).alc
Tim Green - For A Memory.alc
Ellie Goulding - Burn (Gryffin Remix).alc
Miguel Migs - What Do You Want (Rodriguez Jr Remix).alc
Jesper Ryom - Ghostly (Original Mix).alc
CamelPhat, Elderbrook - Cola (Original Mix).alc
Sarah Vaughan - Whatever Lola Wants (Gotan Project Remix).alc
Mathew Jonson & Exercise One - Lost Forever In A Happy Crowd.alc
Mononoid - Ballina (Original Mix).alc
Der Dritte Raum - Hale Bopp (D3R-25 Remix).alc
Rodriguez Jr. - Heal Me (Original Mix).alc
Stephan Bodzin - Singularity (Fur Coat Remix).alc
NiCe7 - Running Man (Latmun Remix).alc
Dusky - Ingrid Is A Hybrid.alc
Mikky Ekko - Kids (The Chainsmokers Remix Club Edit).alc
---
DJ Hell - Guede (ARTBAT Rave Mix).alc
ATTLAS - Further (Original Mix).alc
PTFA - Gornal (Original Upper Mix).alc
Joris Voorn - DM12 (Original Mix).alc
Mike Posner - Cooler Than Me (Hey Champ Remix).alc
Mike Posner - Cooler Than Me (Single Mix).alc
---
Kidnap Kid - Stronger.alc
Mat Zo & Porter Robinson - Easy (Spaveech Remix).alc
Illyus & Barrientos - Takin' Over (Original Mix).alc
Tchami - Adieu (Original Mix).alc
Totally Enormous Extinct Dinosaurs - Your Love (Fake Blood Remix).alc
Nina Simone - Sinnerman (Felix Da Housecat Remix).alc
Soulsearcher - Can't Get Enough (Vocal Club Edit).alc
Daniel Portman - You're Not Alone.alc
The Temper Trap - Fader (Adam Freeland Mix).alc
Lazy Jay - Float My Boat (Bougenvilla Remix Extended).alc
Mikey Lion, Sacha Robotti - Ol' Dirty Hearts.alc
Dave Spoon - At Night.alc
Deadmau5 - Some Chords (Tiny Dancer Edit).alc
Hardwell - Spaceman.alc
Dr Dre - Forgot About Dre.als
Deadmau5 - Some Chords (Tiny Dancer Edit).alc
Emma Hewitt - Rewind (Mikkas Remix).alc
Ian Carey & Rosette & Timbaland & Brasco - Amnesia (Extended Mix).alc
Florence & The Machine - You've Got The Love (Mark Knight Remix).alc
Calvin Harris - I Am Not Alone (Deadmau5 Remix).alc
Jetlag - So Right (Axwell & BT's Essence Dub).alc
Granite and Phunk - Knock U Over.alc
Gus Gus - David (Tim Deluxe Remix).alc
Project 46 - No One (feat. Matthew Steeper) (Original Mix).alc
Bastille - Laura Palmer (Kat Krazy Remix).alc
Brian Eno - An Ending (Leama & Moor Remix).alc
Akon - Beautiful.alc
Damian DP vs Jose Zamora - Transatlantic (Andy Moor Remix).alc
Seven Lions & Myon & Shane 54 - Strangers (feat. Tove Lo).alc
