Alicia Keys - In Common (Black Coffee Remix).alc
Rufus - Sundream (Claptone Remix).alc
Klangkarussell - Sonnentanz (Original Mix).alc
Above & Beyond - Counting Down The Days (Yotto Remix).alc
Goldfrapp - Number 1 (EarthMoonEarth Remix).alc
Sascha Funke - Mango.alc
Dot Allison - Substance.alc
SNBRN - Raindrops (Hotel Garuda Remix).alc
Dev - In The Dark (Main).alc
Alex Adair - Make Me Feel Better (Don Diablo & Cid Remix).alc
Shapeshifters - Lola's Theme (Extended Vocal Mix).alc
NinjaShy - Move Your Bootleg Girl.alc
Luke Chable & Bonnici - Ride (Mashtronic Remix).alc
ilan Bluestone - Atlantis.alc
The Knife - Pass This On (Dahlback And Dahlback Mix).alc
Wiley ft Emeli Sande - Never Be Your Woman (Solo Loves Garage Remix).alc
New Order - Bizarre Love Triangle (Crystal Method Remix).alc
Solidisco ft Nina Simone - Feeling Good.alc
Deorro - Five Hours.als
Calvin Harris & John Newman - Blame (Acapella).als
Finger & Kadel - I Got My Stereo (Original Mix).alc
Infusion - Do To You (In '82).alc
Mat Zo - Synapse Dynamics (Arty Remix).alc
Star Slinger - Take This Up.alc
Bag Raiders - Turbo Love (Shinichi Osawa Remix).alc
The Doors - Hello, I Love You (Freeland Radio Edit) (no scream).alc
Sarah McLeod - He Doesn't Love You (Hook N Sling Vocal Mix).alc
Moloko - Sing It Back (Mousse T's Feel Love Mix).alc
Perasma - Swing 2 Harmony (Gabriel & Dresden Club Mix).alc
Adrian Lux - Strawberry (Original Version).alc
Mr Oizo - Flat Beat.alc
Dr Dre - Forgot About Dre.als
Fatboy Slim - Song For Shelter (Full Single Mix).alc
Eric Prydz - Generate (Original Mix).alc
Clockwork - Surge.alc
Mat Zo - Lucid Dream.alc
TWR72 - Summer.alc
Feist - 1234 (Van She Remix).alc
