--- Part 1:
Alicia Keys - In Common (Black Coffee Remix)
Martin Roth - Mel (Whomi Remix)
Sasha - Channel Deq (Max Cooper Remix)
Tycho - Hours
N'to - Starlings (Henry Saiz Remix)
Nora En Pure - Driving With Whales (Daniel Portman Remix)
Dusky - Skin Deep (Global Communication Remix)
Purity Ring - Repetition
Trentemoller - Moan (Trentemoller Remix)
Radiohead - Talk Show Host (Jett Rework)
Atish - Peculiar Colors (Lee Jones Remix)
Rufus - Innerbloom (H.O.S.H. Remix)
Joe Goddard - Music Is The Answer (Hot Since 82 Remix)
Way Out West - Tuesday Maybe
Jan Blomqvist - Dancing People Are Never Wrong (feat The Bianca Story)
Stephan Bodzin - Strand (Original Mix)
Bob Moses - Tearing Me Up (Slaptop Remix)
Rufus - Like an Animal
Jean-Michel Jarre & M83 - Glory (Steve Angello Remix)
Coleman Hell - 2 Heads
Rihanna - Stay (Ghosts Edit)
Dirk Sid Eno - Morgens In Odonien
Olderic & Peter Pardeike - Connaisseur
Rone - Parade (Dominik Eulberg Remix)
Time (FR) - Bird (Original Mix)
Doctor Dru - Praerie (Original Mix)
Leonard Cohen - You Want It Darker (Paul Kalkbrenner Remix)
Solee - Ten
Kidnap Kid - Stronger
Ben Bohmer - Soulline (Original Mix)
The XX - Crystalized (Whomi Remix)
Jadele - Guilty Pleasure (Kotelett & Zadak Remix)
Eric Prydz - Generate (Kolsch Remix)
Tchami - Adieu (Original Mix)
Adam Beyer, Bart Skils - Your Mind (Original Mix)
Mikey Lion, Sacha Robotti - Ol' Dirty Hearts
FISHER (OZ) - Losing It (Extended)
--- Part 2:
Jeremy Olander - Let Me Feel
Madeon - The City (The M Machine Remix)
Deadmau5 - Imaginary Friends
Deadmau5 - Avaritia
Wolfgang Gartner - Illmerica (Extended Mix)
Galantis - Help (Elephante Remix)
The Chemical Brothers - Star Guitar
Craig Obey vs The Church - Under the Milky Way
Global Deejays - The Sound of San Francisco
Morgan Page - Your Love (feat The Outfield)
Kaskade - Something Something Champs
Galantis - You (Extended Mix)
Deadmau5 - Some Chords (Tiny Dancer Edit)
NERVO & Hook N Sling - Reason
Dennis de Laat - Sound Of Violence (Main Mix)
Avicii - Penguin (Fade Into Darkness) (Vocal Club Mix)
Galantis - Runaway (U & I) (Extended Mix)
Lorde - Team (Elephante Remix)
Der Dritte Raum - Hale Bopp (D3R-25 Remix)
Rodriguez Jr. - Heal Me (Original Mix)
Jesper Ryom - Ghostly (Original Mix)
Subb-an - What I Do (Burnski's Tulum Remix)
Tchami x Janet Jackson - Go Deep
Kaskade - Disarm You (feat. Ilsey) (Extended)
Bastille - Laura Palmer (Kat Krazy Remix)
Panama Wedding - Uma (Jenaux Remix)
Lamb - What Sound (Tom Middleton Deep Step Mix)
Kaskade - Eyes (feat. Mindy Gledhill) (Extended Mix)
Foxes - Youth (Disco Fries Remix)