Royksopp - Remind Me (James Zabiela Ingeborg Mix)
Ame - Rej (Pastaboys Mix)
Yoshimoto - Du What U Du (Trentemoller Remix)
Da Fresh - Spaghetti Groove
Stardust - Music Sounds Better With You (Acapella)
Lindstrom - I Feel Space (Freeform Five Remix)
Juliet - Avalon (Album Version)
Moby - Lift Me Up (Mylo Mix)
Ethan - In My Heart (Original Mix)
Dave Spoon - At Night
Modjo - Lady 1 4x4
Franz Ferdinand - Take Me Out (Hoxton Whores Remix)
Infusion - Do To You (In '82)
Missy Elliot - Lose Control (Jacques Lu Cont Remix)
Macca - I'd Rather Be Alone (Vocal Mix)
Freeform Five - No More Conversations (Mylo Club Mix 2007 Re-edit)
Daft Punk - Harder, Better, Faster, Stronger 4x4
Evermore vs Dirty South - It's Too Late (Ride On)
Bloc Party - Banquet (Boys Noize Vox Mix)
Hyper - We Control
...
Hyper - We Control
Aquasky and Tayo - Looking For A Session
Basement Jaxx - Where's Your Head At (Stanton Warriors Remix)
The Body Snatchers - Rip Shit Up
Praise Cats - Cats Groove (Shined On Me Freestylers Remix)
Coburn - We Interrupt This Programme (Stanton Warriors Remix)
Moguai - Get On (Hyper Remix)
Fatboy Slim - Star 69 (Acapella)
The Prodigy - Smack My Bitch Up
Fischerspooner - Emerge (Dave Clarke Remix)
Prince - When Doves Cry (Unknown white label remix)
Mylo - Drop The Pressure (Kid Kenobi & Pocket Remix)
The Bravery - Honest Mistake (Hoxton Rockers Remix)
Ficta - Eli (James Zabiela Rave Lizard Mix)
check this out?  the beat down?
Elektronauts - Bumper (Plump DJs Remix)
Underworld - Born Slippy
(on one record?!)
Something else...?
Bassnectar vs Groove Armada - Superstylin Smashup
Lamb - What Sound (Tom Middleton Deep Step Mix)
The Police - King Of Pain (DJ Icey Re-Work) (Vinyl Only)
Gnarls Barkley - Crazy (Karl G Remix)
