Dusky - Ingrid Is A Hybrid.alc
Dusky - Skin Deep (Global Communication Remix).alc
Purity Ring - Repetition.alc
Amillionsons - Misti Blu (Schmoov! Dub Mix).alc
Shakka - When Will I See You Again (Amtrac Remix).alc
Pharrell Williams - Happy (Efix & Allison Cover).alc
Above & Beyond - We're All We Need (Spada Remix).alc
Dance Spirit - Late Night Early Mornings (Bedouin Remix).alc
Ben Pearce - What I Might Do (Club Edit).alc
Flashmob - Need In Me.alc
Bicep - Just.alc
Bit Funk & Shae Jacobs - Off The Ground (Extended).alc
Oliver Koletski - No Man No Cry (Worakls Remix).alc
Tove Lo - Habits (Acapella).als
Rufus - My Number vs Charlotte (Foals over Booka Shade).alc
Bob Moses - Tearing Me Up (Slaptop Remix).alc
Foals - Late Night (Solomun Remix).alc
Tube & Berger - Imprint Of Pleasure.alc
Vijay & Sofia Zlatko - Wildest Dreams (Extended Mix).alc
Yotto - Wondering (feat. CAPS).alc
SRTW - We Were Young (Sascha Kloeber Remix).alc
Morgan Page - In The Air (SNBRN Remix).alc
Royksopp - What Else Is There (Trentemoller Remix).alc
Max Manie - Sunday (Klangkarussell Remix).alc
Kenny Loggins - Danger Zone.alc
Above & Beyond - Blue Sky Action (Extended Radio Mix).alc
Survivor - Eye Of The Tiger (Hyperbits & Bender Remix).alc
Calvin Harris - Feel So Close (Extended Mix).alc
Bob Marley - Sun Is Shining (Funkstar Club Mix).alc
Julius Papp - Ain't No Sunshine.alc
Hozier - Take Me To Church (Frost Remix).alc
Paul Kalkbrenner - Jestrupp (Joris Voorn Remix).als
Adrian Lux - Teenage Crime (Axwell Remix).alc
Deadmau5 & Chris James - The Veldt (8 Minute Edit).alc
Global Deejays - The Sound of San Francisco.alc
Russ Chimes - Back 2 You.alc
NERVO & Hook N Sling - Reason.alc
Wrechiski & Jason Ross - Atlas (Original Mix).alc
Kaskade - Disarm You (Acapella).als
---
Worakls - Salzburg.alc
Arty - Kate (2015 Remix).alc
Runaway - Outrageous (Shiloh Remix).alc
Jean Jacques Smoothie - 2 People (Mirwais Extended Mix).alc
Moby - Go (Woodtick Mix).alc
Caribou - Can't Do Without You (Lenno Remix).alc
White Spaces & Jim Kerr - Don't You Forget About Me (Phunk Investigation In The City Mix).alc
Bass Kleph - Keyboard Cat.alc
Claire - Games (Passion Pit Remix).alc
Netsky - Puppy.alc
Afrojack - Ten Feet Tall (Acapella).als
Basto - Again and Again (Extended Mix).alc
The Secret Handshake - Summer of 98.als
The Temper Trap - Sweet Disposition (RAC Mix).alc
Moony - Dove (I'll Be Loving You) (T&F vs. Moltosugo Radio Mix).alc
Chris Malinchak - So Good To Me (Eat More Cake Remix).alc
Monkey Safari - Hi Life (Cheeky Bold Cover).alc
Brother Brown - Under The Water (Frankeepella).alc
Jean-Michel Jarre & M83 - Glory (Steve Angello Remix).alc
Distorted Beauty - Scream (Mario Aureo Remix).alc
Kollektiv Turmstrasse - Ordinary (Lake People's Circle Motive Remix).alc
Tom Odell - Another Love (Zwette Edit).alc
UNKLE vs Petter - What Are You To Me (Sashas Involver Remix).alc
Soulsearcher - Can't Get Enough (Acapella).als
(not really)
Kaskade - It's You, It's Me (Marques Wyatt's Deep Interpretation Remix).alc
Treena Rose - Tell Me All About It (In The Dark Instrumental).alc
Noel Nanton - Your Love (Ian Pooley Summertime Mix).alc
Caesars - Jerk It Out (Acapella).als
Phonat - Set Me Free.alc
Aphex Twin - On (Reload Remix).alc
Orbital - Halcyon + On + On.alc
Sigur Ros - Svefn-g-englar (Innerstate Mix).alc
Orbital - Frenetic (12' Mix).alc
