Junior Boys - In The Morning
Todd Terje - Snooze 4 Love (Dixon Remix)
HearThuG - Yuth (Original Mix)
Trentemoller - Moan (Trentemoller Remix)
YokoO - Oneness
Rufus - You Were Right
Matthias Vogt - World Needs Its Dreamers
Tycho - Hours
Reuben Keeney x Jasmine Thompson - Sweet Child Of Mine
I Am Oak - On Trees And Birds And Fire (Sam Feldt vs Bloombox Remix)
Eric Prydz - Liberate (Lane 8 Remix)
Filous & James Hersey - How Hard I Try
Tez Cadey - Seve (Radio Edit)
Zhu - Gun (Chvrches Cover)
Shura - Touch (Four Tet Remix)
Boehm - Future Self
Chris Malinchak - So Good To Me (Eat More Cake Remix)
Booka Shade - Night Falls
Zhu - Faded (Acapella)
Klingande - Jubel (Original Mix)
Afrojack - Ten Feet Tall (Acapella)
Frank Ocean - Thinkin Bout You (Lonsdale Boys Club Remix)
James Blake - CMYK (eLDOKO Remix)
AfroMystik - Rhythm Is (Marques Wyatt Remix)
The Chemical Brothers - Star Guitar
Van She - (Don't Fear) The Reaper
U2 - Even Better than the Real Thing (Perfecto Mix)
Above & Beyond - Fly To New York (Above & Beyond vs. Jason Ross Club Mix)
Daft Punk - Fragments of Time
RAC & Liz Anjos - 1979
U2 - With Or Without You (Dr Kucho Rework)
Porter Robinson - Language
Benny Benassi - Cinema (Acapella)
Coco Silco - Moon
Mat Zo - Lucid Dreams (Original Mix)
Porter Robinson - The Seconds (feat. Jano) (Original Mix)
BT - Skylarking (Original Mix)
Adrian Lux - Can't Sleep (Netzel Airtime Remix)
MGMT - Kids (Soulwax Remix)
Krewella - Alive (Acapella)
Daft Punk - Digital Love (ALGERONICS Remix)
EDX - Give It Up For Love (Mysto & Pizzi Remix)
Kid Alex - Young Love
Kid Cudi - Day 'N' Nite (Crookers Remix)
Spooky - Belong (Sasha Involver Remix - Prankster Edit)
Avicii & Nicky Romero - I Could Be The One
TWR72 - Summer
Speedcats feat. Owen Jarvis - Speedcats (Roel H Remix)
Parov Stelar - Catgroove
Silversun Pickups - Lazy Eye (Jason Bentley Remix)
Kesha - Die Young
Mighty Mike - Iron Jerk (Caesars vs Woodkid)
Martin Solveig - The Night Out (Single Version)
Eric Prydz - Call On Me (Eric Prydz vs Retarded Funk Remix)
Ian Carey & Rosette & Timbaland & Brasco - Amnesia (Extended Mix)
Deadmau5 - Moar Ghosts n Stuff
The Stranglers - Golden Brown
