--- Terrace:
Rodriguez Jr. - Mistral (Original Mix)
Nick Warren & Guy Mantzur - Sad Robot (D-Nox & Beckers Remix)
Jimpster - Seventh Wave (Dirt Crew Rework)
Ciano - Erode (Original Mix)
Martin Roth - Mel (Whomi Remix)
Notize & Pete Oak - Merula (Martin Roth Remix)
Ten Walls - Requiem
Downtown Party Network - Space Me Out (Ewan Pearson Remix)
Yotto - Aviate
Alicia Keys - In Common (Black Coffee Remix)
J Axel - You Give Me Love
N'to - Starlings (Henry Saiz Remix)
Finnebassen - Touching Me
Flashmob - Need In Me
Eli and Fur - You're So High (Original Mix)
Cubicolor - Got This Feeling
Jan Blomqvist - Stories Over (Aparde Remix)
Armen Miran - Jojo In The Stars
Olafur Arnalds - For Now I Am Winter (Kiasmos Mix)
HearThuG - Yuth (Original Mix)
Tove Lo - Habits (Acapella)
Todd Terje - Snooze 4 Love (Dixon Remix)
Kiani & His Legion - Electric (Fatima Yamaha Remix)
Jody Wisternoff feat. Sian Evans - The Bridge
Miika Kuisma - Trying My New Wings (Jane Maximova Remix)
Don Carlos - Alone (Paradise Version)
Tez Cadey - Seve (Extended Mix)
Filous & James Hersey - How Hard I Try
Junior Boys - In The Morning (Hot Chip Remix)
Junior Boys - In The Morning
Todd Terje - Inspector Norse
Way Out West - Tuesday Maybe
Third Son - Faucet
Bob Moses - Tearing Me Up (Slaptop Remix)
Olivier Giacomotto - Bipolar Star
Stephan Bodzin - Strand (Original Mix)
Rufus - Innerbloom (H.O.S.H. Remix)
Luke Sambe, Filter Bear - Levine's Creatures (Ruede Hagelstein Remix)
Clavis - Equal Arcs (Original Mix)
Sasha - Channel Deq (Max Cooper Remix)
Tycho - Hours
Jesper Ryom - Superluminal (Original Mix)
Henry Saiz - Afraid (Jeremy Olander Remix)
Rufus - Desert Night
Duke Dumont - Need U (100%) (Skreamix)
Ultraista - Smalltalk (Four Tet Remix)
Worakls - Salzburg
Foxes - Youth (Disco Fries Remix)
Eric Prydz - Every Day (Original Mix)
Alex Adair - Make Me Feel Better (Don Diablo & Cid Remix)
Dirty South - Unbreakable (SNBRN Remix)
Circulation - Turquoise (differentGear Remix)
Deadmau5 - Polaris
--- Roof Part 1:
Moony - Dove (I'll Be Loving You) (T&F vs. Moltosugo Radio Mix)
Porter Robinson - Language
Benny Benassi - Cinema (Acapella)
Cazzette - Sleepless (Jenaux & Prince Fox Remix)
Avicii & Nicky Romero - I Could Be The One
Hardwell & Amba Shepherd - Apollo
Deadmau5 & Chris James - The Veldt (8 Minute Edit)
Eric Prydz - Generate (Original Mix)
Kaskade - Something Something Champs
Galantis - You (Extended Mix)
Axwell - Center Of The Universe (Remode)
Morgan Page - Your Love (feat The Outfield)
Avicii - Levels (Clockwork Remix)
Above & Beyond - Alright Now feat. Justine Suissa (Above & Beyond Club Mix)
Russ Chimes - Back 2 You
Naxxos - New Orleans (Original Mix)
Noel Nanton - Your Love (Ian Pooley Summertime Mix)
Jam & Spoon - Find Me (Sally Shapiro Remix)
--- Roof Part 2:
Orbital - Halcyon + On + On
Jeremy Olander - Pinkerton (Finnebassen Remix)
Bicep - Aura (12 Mix)
Darlyn Vlys & Forrest - Colours (Tim Engelhardt Remix)
Trentemoller - Moan (Trentemoller Remix)
Max Manie - Sunday (Klangkarussell Remix)
Dusky - Skin Deep (Global Communication Remix)
Purity Ring - Repetition
Nora En Pure - Driving With Whales (Daniel Portman Remix)
