16BL - Vette (Original Mix)
Nico Stojan, Mira - Born and Raised (Be Svendsen Remix)
Roman Fluegel - 9 Years (DJ Koze Remix)
Rodriguez Jr. - Mistral (Original Mix)
Monolink - Frozen (Rodriguez Jr. Remix)
DAVI - Kayser Soze (Original Mix)
Sebastien Leger - Lanarka (Original Mix)
Booka Shade - In White Rooms (Jonas Rathsman Reprise)
Danijel Kostic - Vinternatt (Nora en Pure & Sons of Maria Remix)
Till Kruger - Jolly (Original Mix)
Sous Sol - Blurred Strings (Original Mix)
Breger - Gemeinsam (Langegarden Remix)
Stephan Bodzin - Odyssee
Kidnap Kid - Where the Sea Swings in Like an Iron Gate (Original Mix)
Giovanna - Dream World (Tom Demac Remix)
Jan Blomqvist - The Space In Between (Ben Bohmer Extended Remix)
Monkey Safari - Dodge (Victor Ruiz Remix)
Matthias Vogt - Nostalgia
Andhim - Boy Boy Boy (Joris Voorn Remix)
Ten Walls - Gotham
Fort Romeau - Secrets & Lies
Djuma Soundsystem, Westerby - Disambigua (Original Mix)
Sasha - Xpander (Neil Browne Remix)
Guy Gerber, Dixon - No Distance (Original Mix)
Evren Ulusoy - The Encounter (Sous Sol Remix)
Mihai Popoviciu - Flux (Pornbugs Remix)
Einmusik - I.D.C.
Marc Romboy - Counting Comets (Ruede Hagelstein Remix)
Way Out West - Tuesday Maybe
Third Son - Faucet
Rodriguez Jr. - Radian (Original Mix)
Royksopp - Remind Me (James Zabiela Ingeborg Mix)
N'to - Starlings
Yotto - Personal Space
