Till Kruger - Jolly (Original Mix)
Atish - Peculiar Colors (Lee Jones Remix)
Andhim - Boy Boy Boy (Joris Voorn Remix)
Gorje Hewek & Izhevski - Calinerie
Matthias Vogt - Nostalgia
BAAL - Lumen
Sasha - Xpander (Neil Browne Remix)
Rufus - Innerbloom (H.O.S.H. Remix)
Stephan Bodzin - Strand (Original Mix)
Jan Blomqvist - Dancing People Are Never Wrong (feat The Bianca Story)
Third Son - Faucet
Sunshine Jones - The Sun
HearThuG - Yuth (Original Mix)
Todd Terje - Snooze 4 Love (Dixon Remix)
Bicep - Just
Don Carlos - Alone (Paradise Version)
Jody Wisternoff feat. Sian Evans - The Bridge
Way Out West - Tuesday Maybe
Shura - Touch (Four Tet Remix)
Gorillaz - We Got The Power (Claptone Remix)
Matthew Dekay & Lee Burridge - Lost In A Moment
---
Xinobi - Far Away Place (Jody Wisternoff & James Grant Remix)
Mahmut Orhan - Vesaire (Boral Kibil Remix)
Time (FR) - Bird (Original Mix)
Rone - Parade (Dominik Eulberg Remix)
Dirk Sid Eno - Morgens In Odonien
David Mayer, Sooma - Drained (Original Mix)
H.O.S.H., Andhim - Captain (Original Mix)
Kollektiv Turmstrasse - Ordinary (Lake People's Circle Motive Remix)
Michael Jackson - Man In The Mirror (Peer Kusiv & Rauschhhau Edit)
Doctor Dru - Praerie (Original Mix)
Blunted Dummies - House for All (Ruede Hagelstein Ecstatic Dub)
Ada - Maps (Michael Mayer & Tobias Thomas Remix)
Kaskade - It's You, It's Me (Marques Wyatt's Deep Interpretation Remix)
Treena Rose - Tell Me All About It (In The Dark Instrumental)
Stephan Bodzin & Marc Romboy - Atlas (Album Edit)
Jack U & Ember Island - Where Are U Now (Gamper & Dadoni Remix)
Behrouz - Endless Summer
Maribou State - Wallflower (Lane 8 Remix)
Eric Prydz - Generate (Kolsch Remix)
Daft Punk - Digital Love
Kav Verhouzer - It's All Good (Original Mix)
Say Lou Lou - Julian (The Chainsmokers Remix)
Starsailor - Four To The Floor (Thin White Duke Mix)
Darlyn Vlys & Forrest - Colours (Tim Engelhardt Remix)
Ame - Rej (Original Mix)
Kenny Leaven - Feeling Spicy
Low - Tonight (Acapella)
Alicia Keys - Feelin Me Feelin U (Sole Channel Main Mix)
Angus & Julia Stone - Big Jet Plane (David Dann Remix)
Worakls - Salzburg
Sascha Funke - Mango
Dirty South - Unbreakable (SNBRN Remix)
PTFA - Gornal (Original Upper Mix)
---
Luniz - I Got 5 On It
Rihanna - Umbrella (feat. Jay-Z)
Public Service Broadcasting - Go!
Twin Shadow - Five Seconds
Tycho - Awake
Germany Germany - Natural (ft. Donne of TLGLTP)
Commix - Emily's Smile
The Postal Service - Such Great Heights
Nina Simone - Black Is The Color Of My True Loves Hair (Jaffa Remix)
Broods - Mother & Father
Beyonce - XO
