- Part 1:
Hraach - Burned the Strings (Original Mix)
Catz n Dogs & dOP - Deaf Wagrant (Selianka Edit)
Nicolas Jaar - And I Say (Xinobi Edit)
Polo & Pan - Bakara (Original Mix)
Modd - Road To San Vicente (Original Mix)
HVOB - Always Like This (Oliver Koletzki Radio Edit)
Flight Facilities - Crave You (Original Mix)
Tycho - Epoch
Hoj, Modd, Amega - Telefade (Bedouin Remix)
Switchdance - O Amolador (Original Mix)
Sebastien Leger - Rocket To Lee's Little Cloud (Original Mix)
Fatima Yamaha - What's a Girl to Do
Kora (CA) - Caddo (Original)
Avidus - Revenge of the Whales (Original Mix)
Martin Roth - Mel (Whomi Remix)
Notize & Pete Oak - Merula (Martin Roth Remix)
Alicia Keys - In Common (Black Coffee Remix)
Rufus - Sundream (Claptone Remix)
Rodriguez Jr. - Mistral (Original Mix)
Nick Warren & Guy Mantzur - Sad Robot (D-Nox & Beckers Remix)
Oovation - Falter (Juan Deminicis Remix)
Dusky - Skin Deep (Global Communication Remix)
Purity Ring - Repetition
Kyodai - Marea (Original Mix)
Nora En Pure - Driving With Whales (Daniel Portman Remix)
Guy Gerber, Dixon - No Distance (Original Mix)
Ben Howard - Hideaway (Kiesza Cover) (Vijay & Sofia Zlatko Remix)
Atish - Peculiar Colors (Lee Jones Remix)
Rufus - Innerbloom (H.O.S.H. Remix)
Andhim - Boy Boy Boy (Joris Voorn Remix)
Matthias Vogt - Nostalgia
Djuma Soundsystem, Westerby - Disambigua (Original Mix)
Ben Pearce - What I Might Do (Club Edit)
Above & Beyond - We're All We Need (Spada Remix)
Stephan Bodzin - Strand (Original Mix)
Olivier Giacomotto - Bipolar Star
Bob Moses - Tearing Me Up (Slaptop Remix)
Oliver Koletski - No Man No Cry (Worakls Remix)
Tove Lo - Habits (Acapella)
Yotto - Personal Space
Distorted Beauty - Scream (Mario Aureo Remix)
Luttrell - Contact (Original Mix)
Dirk Sid Eno - Morgens In Odonien
Olderic & Peter Pardeike - Connaisseur
Rone - Parade (Dominik Eulberg Remix)
Wood, Ben Bohmer, Simon Krause - Give Me (Original Mix)
Time (FR) - Bird (Original Mix)
Kollektiv Turmstrasse - Ordinary (Lake People's Circle Motive Remix)
Fatboy Slim - Sunset (Bird of Prey) (Spieltape Remix)
Eagles & Butterflies - X
Doctor Dru - Praerie (Original Mix)
Escape - Just Escape (Justin Martin Remix)
The Cure - Just Like Heaven (The Penelopes Remix)

- Part 2:
SRTW - We Were Young (Sascha Kloeber Remix)
Sigur Ros - Saegoplur (Paolo Mojo Remix)
Bicep - Back 2 U (Original Mix)
Jeremy Olander - Pinkerton (Finnebassen Remix)
Paul Simon - Homeless (Joris Voorn Kitchen Table Mix + The Duke of New York's Edit)
Paul Simon - Homeless (Joris Voorn Remix)
Subb-an - What I Do (Burnski's Tulum Remix)
Eli Brown, Mason Maynard - Jungle Cry (Original Mix)
Patrice Baumel - Surge
Tchami x Janet Jackson - Go Deep
Djuma Soundsystem - Les Djinns (Trentemoller Remix)
Above & Beyond - Counting Down The Days (Yotto Remix)
Alex Adair - Make Me Feel Better (Don Diablo & Cid Remix)
Zhu - Stay Closer
London Grammar - Hell to the Liars (Kolsch Remix)
Jon Hopkins - Open Eye Signal (George FitzGerald Remix)
Orbital - Belfast
Frankey & Sandrino - Acamar (Original)
Kaskade - Eyes (feat. Mindy Gledhill) (Extended Mix)
Chris Malinchak - So Good To Me (Eat More Cake Remix)
Worakls - When The Birds Go In The Wrong Way
Monkey Safari - Walls (Original Mix)
Bob Moses - Like It Or Not (Joris Voorn Remix)
Ada - Maps (Michael Mayer & Tobias Thomas Remix)
Peer Kusiv - Let Her Go
The Chemical Brothers - Wide Open (Kolsch Remix)
Paul Kalkbrenner - Aaron (DVW Remix)
UNKLE vs Petter - What Are You To Me (Sashas Involver Remix)