(Part 1)
--- DJ Peter Henry:
Mahmut Orhan - Vesaire (Boral Kibil Remix)
Xinobi - Far Away Place (Jody Wisternoff & James Grant Remix)
Michael Jackson - Man In The Mirror (Peer Kusiv & Rauschhhaus Edit)
Monolink - Burning Sun (DAVI Remix)
John Monkman & Pete Tong - Aurora
Solee - Ten
Elderbrook - How Many Times (Andhim Remix)
Escape - Just Escape (Justin Martin Remix)
Xinobi - Spend The Night
Yoni Yarchi, Tal Tager - In Another Dimension (Powel Remix)
Hraach - Burned the Strings (Original Mix)
Haim - Falling (Duke Dumont Remix)
Be Svendsen - Twilight in Tankwa (Original Mix)
Bedouin - Set The Controls For The Heart Of The Sun (Original Mix)
Gregory Porter - Liquid Spirit (Claptone Remix)
Whilk & Misky - Clap Your Hands (Solomun Remix)
Frankey & Sandrino - Acamar (Original)
Third Son - Faucet
Way Out West - Tuesday Maybe
Foals - Late Night (Solomun Remix)
Bob Moses - Tearing Me Up (Slaptop Remix)
Oliver Koletski - No Man No Cry (Worakls Remix)
Tove Lo - Habits (Acapella)
Till Kruger - Jolly (Original Mix)
Worakls - Salzburg
Bear Mountain - Faded (Natural Animal Remix)
Alphabeat - DJ (Madeon Remix)
Dusky - Ingrid Is A Hybrid
Dusky - Skin Deep (Global Communication Remix)
Purity Ring - Repetition
Rodriguez Jr. - Ellipsism (Original Mix)
Sascha Funke - Mango
--- DJ Dylon:
Dirty South - Unbreakable (SNBRN Remix)
Above & Beyond - We're All We Need (Extended Mix)
Eric Prydz - Every Day (Original Mix)
Ivan Gough & Feenixpawl - In My Mind (Axwell Remix)
Kaskade - Something Something Champs
Quintino - Escape (Into The Sunset)
--- DJ Peter Henry:
Neon Trees - Sleeping With A Friend (Kat Krazy Extended Mix)
Mat Zo & Porter Robinson - Easy (Extended Mix)
U2 - With Or Without You (Dr Kucho Rework)
Adrian Lux - Teenage Crime (Axwell Remix)
Adrian Lux - Can't Sleep (Netzel Airtime Remix)
MGMT - Kids (Soulwax Remix)
Krewella - Alive (Acapella)

(Part 2)
Cazzette - Sleepless (Jenaux & Prince Fox Remix)
Project 46 - Faces
Galantis - You (Extended Mix)
--- DJ Dylon:
Kaskade - Something Something Champs
(Yes, again...)
Deadmau5 - Some Chords (Tiny Dancer Edit)
Tim Berg - Seek Bromance (Avicii Vocal Extended)
Eric Clapton - Cocaine (Koyote Bootleg)
--- DJ Peter Henry (now pretty drunk...):
Foxes - Youth (Disco Fries Remix)
Hot Chip - I Feel Better
Carmen McRae - How Long Has This Been Going On (MJ Cole Remix)
Future Islands - Seasons (DJ Dodger Stadium Remix)
Tula - Wicked Games (James Carter & Levi Remix)
N'to - Starlings (Henry Saiz Remix)
Dickystixxx - Make Me Feel Better (Club Edit)
Kyodai - Marea (Original Mix)
Rufus - Innerbloom (H.O.S.H. Remix)
Stephan Bodzin - Strand (Original Mix)
Jean-Michel Jarre & M83 - Glory (Steve Angello Remix)
Mylo - Paris 400 (Etienne De Crecy Remix)
Passion Pit - Carried Away (Acapella)
Bicep - Just
Eli and Fur - You're So High (Original Mix)
Thor Rixon - The Clown (Few Nolder Remix)
16 Bit Lolitas - Deep In My Soul
Tube & Berger - Imprint Of Pleasure
Snakadaktal - The Sun II (Just Kiddin Remix)
Everything But The Girl - The Future of the Future (Stay Gold)
Steve Brian - Avocado (Cabriolet Paris Remix)
Nihils - Help Our Souls (Urban Contact Remix)
Specialivery - Aton
Coleman Hell - 2 Heads
Rihanna - Stay (Ghosts Edit)
Yotto - Personal Space
Matthew Dekay & Lee Burridge - Lost In A Moment (Dixon Rework)
Justice vs Simian - We Are Your Friends (Original Mix)
Duke Dumont - I Got U (Kav Verhouzer Resouled Mix)
Rufus - Take Me (Cassian Remix)
Lane 8 - Midnight
Worakls - When The Birds Go In The Wrong Way
