Purity Ring - Obedear
Purity Ring - Grammy (Soulja Boy Cover)
Machineheart - Circles (Vanic Version).alc
American Authors - Best Day Of My Life (Just A Gent Remix)
Birdy - Skinny Love (TEEMID Remix)
Bassnectar - So Butterfly (2014 Version)
Montell Jordan - This Is How We Do It (Acappella)
Goosebumpz - Texas Teeth
Cosmo Sheldrake - The Fly
Chvrches - The Mother We Share (Moonboots Remix)
James Hersey - Coming Over (Filous Remix)
Mikky Ekko - Kids (Monsieur Adi Remix)
DJ Sammy - Heaven (Thero Remix)
Above & Beyond - Sticky Fingers (Lane 8 Remix)
Mr Probz - Waves (Robin Schulz Remix)
Joris Voorn - Ringo (Original)
Zedd - Stay The Night (Acapella)
Duke Dumont - I Got U (Kav Verhouzer Resouled Mix)
Klingande - Jubel (Original Mix)
Afrojack - Ten Feet Tall (Acapella)
Frank Ocean - Thinkin Bout You (Lonsdale Boys Club Remix)
Zhu - Faded
Rufus - Take Me (Cassian Remix)
Tove Lo - Stay High (Habits Remix)
Ryan Hemsworth - Perfectly
Zhu - Cocaine Model (Bender Remix)
Mat Zo & Porter Robinson - Easy (Spaveech Remix)
Sam Smith - Stay With Me (Throttle Remix)
Lorde - Team (Elephante Remix)
Mumford & Sons - I Will Wait (Bloombox & Sam Feldt Remix)
Faul & Wad Ad vs. Pnau - Changes (Tocadisco's Sunny LA Remix)
Brass Knuckles - Bad Habits (Joe Maz Remix)
MAKJ & Lil Jon - Let's Get Fucked Up
Audien - Hindsight (Original Mix)
3LAU - How You Love Me (Acapella)
Bastille - Laura Palmer (Kat Krazy Remix)
Smallpools - Dreaming (The Chainsmokers Remix)
Icona Pop - I Love It
DJ Ross & Marvin - Baker Street (Extended Mix)
Galantis - Help (Elephante Remix)
Calvin Harris - Feel So Close (Extended Mix)
Hardwell - Cobra (Official Energy Anthem 2012)
Mark Morrison - Return Of The Mack (Acapella).alc
Netsky - Puppy
Sash! - Ecuador (Wax Motif 2012 Wikileaks Remix)
Porter Robinson - Language
Benny Benassi - Cinema (Acapella)
Krewella - Alive (Acapella)
Hardwell & Amba Shepherd - Apollo
Deadmau5 - The Veldt (Tommy Trash Remix)
Foster The People - Don't Stop (Oliver Remix)
Neon Trees - Sleeping With A Friend (Kat Krazy Extended Mix)
EDX - Give It Up For Love (Mysto & Pizzi Remix)
Adrian Lux - Alive (Basto Dub)
U2 - With Or Without You (Dr Kucho Rework)
David Guetta & Usher - Without You (Extended Version)
Adrian Lux - Can't Sleep (Netzel Airtime Remix)
Porter Robinson - The Seconds (feat. Jano) (Original Mix)
Snow Patrol - Open Your Eyes (Steve Brian & Oudai Abdulhadi Bootleg)
Caribou - Can't Do Without You (Lenno Remix)
Alesso - Heroes (Feat. Tove Lo) (Extended Mix)
Kaskade - Eyes (feat. Mindy Gledhill) (Extended Mix)
Etherwood - Begin By Letting Go (Original)
Broods - Mother & Father
