Close Encounters of the Third Kind
Djuma Soundsystem - Les Djinns (Trentemoller Remix)
Melanie Martinez - Carousel (SNBRN Remix)
Ten Walls - Requiem
Radiohead - Talk Show Host (Jett Rework)
Gus Gus - Crossfade (Maceo Plex Mix)
London Grammar - Hey Now (Sasha Remix)
Kyodai - Marea (Original Mix)
Nils Hoffmann - Balloons (Martin Roth Remix)
FCL - It's You (Bordertown Deep Booty)
Sander van Doorn - Guitar Track (Sam Feldt Remix)
Sasha - Xpander (Neil Browne Remix)
Andhim - Boy Boy Boy (Joris Voorn Remix)
Todd Terje - Snooze 4 Love (Dixon Remix)
Yotto - Mulholland 99
HearThuG - Yuth (Original Mix)
Rufus - Like an Animal
London Grammar - Nightcall (Joe Goddard Remix)
Gregory Porter - Liquid Spirit (Claptone Remix)
Michael Jackson - Man In The Mirror (Peer Kusiv & Rauschhhaus Edit)
Mano Le Tough - Primative People (Tale Of Us Remix)
Destiny's Child - Say My Name (Cyril Hahn Remix)
Inner City - Good Life (Kobhi Bootleg)
Florence And The Machine - Spectrum (Calvin Harris Extended Remix)
Kaskade - Never Sleep Alone (Extended)
Eric Prydz - Generate (Kolsch Remix)
Ame - Rej (Original Mix)
Bassnectar - So Butterfly (2014 Version)
Montell Jordan - This Is How We Do It (Acappella)
Carousel - Let's Go Home (Sound Remedy Remix)
Mikky Ekko - Kids (Oliver Nelson Remix)
Golden Coast - Futurist (Eau Claire Remix)
Phoenix - Lisztomania (Classixx Version)
Friendly Fires - Paris (Aeroplane Remix)
Coolio - Fantastic Voyage
(...and DJ Dylon)

Part 2:
Haim - Don't Save Me (Cyril Hahn Remix)
Arty - Kate (2015 Remix)
Netsky - Puppy
Afrojack - Ten Feet Tall (Acapella)
Caribou - Can't Do Without You (Lenno Remix)
Sasha - Belfunk
ATB - 9 PM (Till I Come)
Galantis - Smile (Extended Mix)
Above & Beyond - Fly To New York (Above & Beyond vs. Jason Ross Club Mix)
Feed Me & Crystal Fighters - Love Is All I Got (Original Mix)
The Chemical Brothers - Star Guitar
AfroMystik - Rhythm Is (Marques Wyatt Remix)
Frank Ocean - Thinkin Bout You (Lonsdale Boys Club Remix)
Dirty Vegas - Days Go By
Zhu - Faded
Rufus - Take Me (Cassian Remix)
Swedish House Mafia - Save The World (Zedd Remix)
Calvin Harris - Summer (Elephante Remix)
Neon Trees - Sleeping With A Friend (Kat Krazy Extended Mix)
Porter Robinson - Language
Benny Benassi - Cinema (Acapella)
Cazzette - Sleepless (Jenaux & Prince Fox Remix)
Avicii - Dear Boy
Avicii feat Aloe Blacc - Wake Me Up (Dr Pihl's Throwback Remix) 128
Gramatik - Native Son Prequel (Jenaux Remix)
Sam Feldt - Show Me Love
Above & Beyond - We're All We Need (Extended Mix)
Eric Clapton - Cocaine (Koyote Bootleg)
Future Islands - Seasons (DJ Dodger Stadium Remix)
Vitalic - Fade Away (Vitalic Formentera Rework)
Worakls - Salzburg
Jonsi - Around Us (The Chainsmokers Remix)
Snow Patrol - Open Your Eyes (Steve Brian & Oudai Abdulhadi Bootleg)
Kaskade - 4 AM (Adam K & Soha Mix)
EDX - Give It Up For Love (Mysto & Pizzi Remix)
Sash! - Ecuador (Wax Motif 2012 Wikileaks Remix)
Deadmau5 & Kaskade - I Remember (Vocal Mix)
Adrian Lux - Can't Sleep (Netzel Airtime Remix)
Bingo Players - Cry (Just A Little)
Deadmau5 - The Veldt (Tommy Trash Remix)
Mat Zo - Lucid Dreams (Original Mix)
MGMT - Kids (Soulwax Remix)
Krewella - Alive (Acapella)
