Daft Punk - Doin' it Right
DJ Marky and XRS - LK
London Elektricity - Just One Second (Apex Remix)
Birdy - Skinny Love (Fareoh Remix)
VV Brown - Shark In The Water (Blame Remix)
Empire Of The Sun - We Are The People (Sub Focus Remix)
Netsky - Iron Heart
Devin The Dude - I'm Just Gettin' Blowed
Feist - I Feel It All (Britt Daniel Remix)
Peter Schilling - Major Tom
The Weeknd - Often (Kygo Remix)
Alan Walker - Faded
Fugees - Ready Or Not (DJ Zinc 2003 Mix)
Twin Shadow - Five Seconds
The Submarines - 1940 (AmpLive Remix)
RJD2 - Ghostwriter
Jurassic 5 - What's Golden
DJ Jazzy Jeff & The Fresh Prince - Summertime
Deltron 3030 - Mastermind
Lorde - Tennis Court (Flume Remix)
Noosa - Walk On By (Sound Remedy Remix)
Toto - Africa
Notorious B.I.G. - Going Back To Cali (Viceroy Jet Life Remix)
Coolio - Fantastic Voyage
The Orb - Little Fluffy Clouds
Bassnectar - Replenish
Finnebassen - Vi Na (Original Mix)
Lana Del Rey - Summertime Sadness
Odesza - Say My Name (Jai Wolf Remix)
Joywave - Tongues (feat. Kopps)
Dolly Parton - Jolene (Todd Terje remix)
Polo & Pan - Bakara (Original Mix)
CHVRCHES - Clearest Blue (Gryffin Remix)
Asaf Avidan & The Mojos - Ghost (Your Heart For Me) (Suko Edit)
Milky Chance - Stolen Dance (Alex Brandt's Saxual Edit)
Chris Malinchak - So Good To Me (Original Mix)
Sam Shure - Kasra (Atish Remix)
Chillion & Seren - Wicked Game
Dusky - Tiers (Original Mix)
Kora (CA) - Caddo (Original)
Jesper Ryom - Ghostly (Original Mix)
Luca Bacchetti - Atlantic (Original Mix)
Jask - Surrender Your Love
Kiesza - Take Me To Church (Hozier Cover) (George Whyman Remix)
Lady Gaga - Telephone (feat. Beyonc√©)
Royksopp & Robyn - Do It Again
Gus Gus - Crossfade (Maceo Plex Mix)
Nora En Pure - Driving With Whales (Daniel Portman Remix)
Gorge - Ajala (Original Mix)
Jan Blomqvist - Winter Roads (Extended Mix)
Jon Hopkins - Open Eye Signal (George FitzGerald Remix)
Bob Moses - Tearing Me Up (Slaptop Remix)
Olivier Giacomotto - Bipolar Star
David Guetta & Showtek - Bad (The Rooftop Boys Remix)
Jody Wisternoff feat. Sian Evans - The Bridge
The Weeknd - Often (Kygo Remix) (again by popular demand)
Jess Mills - For My Sins (Etherwood Remix)
Yuna - Lullabies (Adventure Club Remix)
Bruno Mars - Locked Out Of Heaven (The M Machine Remix)
