The Faint - The Conductor (Thin White Duke Remix)
Ethan - In My Heart (Original Mix)
Golden Boy & Miss Kittin - Rippin Kittin (TV Rock Remix)
Pashka - Island Breeze (Trentemoller Mix)
Zhu - Faded
Fat Sushi - Menage a Trois
Darius Syrossian, Doorly - Gravity Check (Original Mix)
Stephan Bodzin - Strand (Original Mix)
Rufus - Innerbloom (H.O.S.H. Remix)
Bear Mountain - Faded (Natural Animal Remix)
Calvin Harris & Ellie Goulding - I Need Your Love (Acapella)
Way Out West - Tuesday Maybe
Luttrell - Contact (Original Mix)
Zhu - Gun (Chvrches Cover)
Jean-Michel Jarre & M83 - Glory (Steve Angello Remix)
Micrologue - Tourmaline (Original Mix)
16 Bit Lolitas - Deep In My Soul
Kollektiv Turmstrasse - Ordinary (Lake People's Circle Motive Remix)
Rone - Parade (Dominik Eulberg Remix)
Olderic & Peter Pardeike - Connaisseur
Death on the Balcony - Solar Lives (DOTB Mix)
Spieltape - Fountainhead (Mihai Popoviciu Remix)
Elderbrook - How Many Times (Andhim Remix)
John Monkman & Pete Tong - Aurora
Xinobi - Spend The Night
Deadmau5 - Imaginary Friends
Deadmau5 - Avaritia
Lutzenkirchen - Music For The Girls (Huggotron Remix)
The Postal Service - Such Great Heights (John Tejada Remix)
Worakls - Far Far Away
Oceanlab - Another Chance (Above & Beyond Club Mix)
Reflekt - Need To Feel Loved (Adam K & Soha Vocal Mix)
Circulation - Turquoise (differentGear Remix)
Damian DP vs Jose Zamora - Transatlantic (Andy Moor Remix)
Future Islands - Seasons (DJ Dodger Stadium Remix)
Foxes - Youth (Disco Fries Remix)
