Quintino - Escape (Into The Sunset)
Lana Del Rey - Young & Beautiful (Nikno Remix)
EDX - Give It Up For Love (Mysto & Pizzi Remix)
Sash! - Ecuador (Wax Motif 2012 Wikileaks Remix)
Deadmau5 & Kaskade - I Remember (Vocal Mix)
Adrian Lux - Can't Sleep (Netzel Airtime Remix)
Ce Ce Peniston - Finally (Forever Kid Remix)
The Crystal Method - Born Too Slow (Deepsky Green Absinthe Mix)
TWR72 - Summer
Carlos Russo - Massive Joy (Thomas Gold Remix)
Andreas Johnson - Glorious (Hybrid Remix)
Gabriel & Dresden - Portobello
Delphic - This Momentary (ALGERONICS Remix)
Mylo - Drop The Pressure (Kid Kenobi & Pocket Remix)
Bassbin Twins - ESW
Ficta - Eli (James Zabiela Rave Lizard Mix)
The Police - King Of Pain (DJ Icey Re-Work) (Vinyl Only)
The Prodigy - Smack My Bitch Up
Fischerspooner - Emerge (Dave Clarke Remix)
NiT GriT vs Stellamara - Prituri Se Planinata (NiT GriT Remix)
Tritonal & Cristina Soto - Still With Me (Seven Lions Remix)
Daughter - Medicine (Sound Remedy Remix)
SirensCeol - Coming Home
Foxes - Youth (Adventure Club Dubstep Remix)
Britney Spears - Till The World Ends (Adventure Club Dubstep Remix)
Cut and Run - Murder In The Jamrock
Skrillex - Fire Away
Craig Obey vs The Church - Under the Milky Way
Layo & Bushwacka! - Let The Good Times Roll
Jack Shaft - Superlogical
Above & Beyond - Fly To New York (Above & Beyond vs. Jason Ross Club Mix)
