Rampue - Leporidae (Original Mix)
Luc Angenehm - Morning Tea
Upercent - Tirant Lo Blanc (Original Mix)
David August - Epikur
Martin Roth - Mel (Whomi Remix)
--- DJ Dylon:
Above & Beyond - Sticky Fingers (Lane 8 Remix)
Nora En Pure - Morning Dew
Rufus - You Were Right
--- DJ Peter Henry:
Purple Disco Machine - Walls
Ben Pearce - What I Might Do (Club Edit)
Atish - Peculiar Colors (Lee Jones Remix)
Stephan Bodzin - Odyssee
WoodS (NL) - Desert Storms (Joris Voorn Remix)
Brian Cid - Rotations
Big Muff - My Funny Valentine (Francois K Body and Soul Mix)
Till Kruger - Jolly (Original Mix)
Kidnap Kid - First Light
Justin Martin - Don't Go (Dusky Remix)
Gorillaz - We Got The Power (Claptone Remix)
Tube & Berger - Imprint Of Pleasure
BATTS - Morals (Martin Roth Remix)
16 Bit Lolitas - Deep In My Soul
Solee - Dromen (Original Mix)
MOGUAI, Zonderling - Lee (Instrumental Mix)
The Chemical Brothers - Wide Open (KÃ¶lsch Remix)
Mr. V - Riddims (Organ Mix)
Tchami - Adieu (Original Mix)
Scissor Sisters - Mary (Mylo Remix)
Rauschhaus - Magnolia (Original Mix)
Solee - Ten
Jadele - Guilty Pleasure (Kotelett & Zadak Remix)
Behrouz - Endless Summer
Maribou State - Wallflower (Lane 8 Remix)
Mikey Lion, Sacha Robotti - Ol' Dirty Hearts
X-Press 2 - Smoke Machine (James Talk Remix)
Roland Clark - I Get Deep (Late Nite Tuff Guy vs Emanuel Satie Rework)
The Temper Trap - Sweet Disposition (Undercatt Remix)
Darlyn Vlys & Forrest - Colours (Tim Engelhardt Remix)
Royksopp - What Else Is There (Trentemoller Remix)
Bicep - Aura (12 Mix)
Bob Marley - Sun Is Shining (Jesse Rose Bootleg Mix)
