Sasheen, Jacob Acosta - Falling (Original Mix)
Acid Pauli, Monolink - New Morning (Original Mix)
Eleonora, Bigasti - Fjords (Armen Miran Remix)
&ME, Rampa, Adam Port - MuyeÌ€ (Black Coffee Remix)
Way Out West - Lullaby Horizon (Ben Bohmer Extended Mix)
Wood - Irs13 (Ben Bohmer Remix)
Nox Vahn, Marsh, Mimi Page - Follow Me (Extended Mix)
Modd - Guron (Original Mix)
Andain - Beautiful Things (Studio Acapella)
Dirk Sid Eno - Morgens In Odonien
Olderic & Peter Pardeike - Connaisseur
Death on the Balcony - Solar Lives (DOTB Mix)
Rone - Parade (Dominik Eulberg Remix)
Time (FR) - Bird (Original Mix)
Rudy UK - Spirit (Original Mix)
David Hohme - Without Doubt (Rodriguez Jr. Remix)
Claptone - Under the Moon (Original Mix)
Phantoms - Cocaine (Original Mix)
Lana Del Rey - Video Games (Joris Voorn Edit)
Orbital - Halcyon + On + On
Alaska In Winter - Space Eagle
Jeremy Olander - Pinkerton (Finnebassen Remix)
Nicolas Jaar - El Bandido (Original Mix)
Tinush - Struggle (Franky Rizardo Sunset Mix)
EMBRZ - Breathe (Original Mix)
BAILE - Without (Tim Green Remix)
Yotto - Nova (Cassian Extended Mix)
Sofi Tukker, Betta Lemme - Awoo
Deep House Soldiers - In My Bag
Jam & Spoon - Find Me (Sally Shapiro Remix)
Infinity Ink - Full Capacity (Joris Voorn Remix)
Eekkoo & Sailor & I - Letters (Lower Case) (Doctor Dru Remix)
Royksopp - Sordid Affair (Maceo Plex Mix)
Sorcha Richardson - Last Train (Lexer Remix)
Kaskade & Felix Cartal - Fakin It
Yotto - Turn It Around (Monkey Safari Extended Mix)
Say Lou Lou - Julian (The Chainsmokers Remix)
Moony - Dove (I'll Be Loving You) (T&F vs. Moltosugo Radio Mix)
Pete Heller - Big Love (Dr Packer Extended Remix)
Behrouz - Endless Summer
Nora En Pure - Epiphany (Original Club Mix)
Moby - Lift Me Up (Mylo Mix)