Etherwood - Begin By Letting Go (Original)
James Blake - The Wilhelm Scream
Blackstreet - No Diggity
Atmosphere - Minnesota Nice
Ellie Goulding - High For This (William Carney Remix)
Deadmau5 & Kaskade - I Remember (J Majik & Wickaman Remix)
Luniz - I Got 5 On It
Skeletone & Silence Groove - Calling for You
Macca - Love Is Tender (Hosta Drum & Bass Remix)
Jakwob - Right Beside You (Etherwood Bootleg)
Rufus - Desert Night (Hybrid Minds Remix) 128
Above & Beyond - Blue Sky Action (Logistics Remix)
Eric Prydz - Every Day (Andy C Remix)
Porter Robinson - Sad Machine
EMBRZ - Slow Down
--- DJ Dylon:
Above & Beyond - We're All We Need (SpectraSoul Remix)
Porter Robinson - Sad Machine (thanks Dylon...)
Totally Enormous Extinct Dinosaurs - Garden (Calbre Remix)
Deadmau5 - Brazil
Morgan Page - The Longest Road (Deadmau5 Remix)
Morgan Page - The Longest Road (Deadmau5 Some Other Remix)
Deadmau5 - Professional Griefers (Instrumental Mix)
Deadmau5 - You There   Longest Road (Some Mashup)
--- DJ Peter Henry:
Alex Dimou & Black Soda - This Time
Kora (CA) - Caddo (Original)
CamelPhat, Elderbrook - Cola (Original Mix)
Tim Green - For A Memory
Fatima Yamaha - What's a Girl to Do
Mononoid - Ballina (Original Mix)
Jesper Ryom - Ghostly (Original Mix)
Rauschhaus - Purple
Joris Voorn - Ringo (Original)
Alicia Keys - In Common (Black Coffee Remix)
Notize & Pete Oak - Merula (Martin Roth Remix)
Purple Disco Machine - Drumatic
Lindstrom - I Feel Space (Freeform Five Remix)
Leonard Cohen - You Want It Darker (Paul Kalkbrenner Remix)
Dajae, Detlef - Deep Dip (Original Mix)
Nihils - Not A Man Of Violence (Ghosts Remix)
Here Is Why - Tonight (Adam Port 12'' Autobahn Edit)
David Mayer, Sooma - Drained (Original Mix)
Time (FR) - Bird (Original Mix)
Snakadaktal - The Sun II (Just Kiddin Remix)
Doctor Dru - Praerie (Original Mix)
Nora En Pure - True (Lexer Remix)
