Bear Mountain - Faded (Natural Animal Remix)
Shift K3y - Name & Number (Wax Motif Remix)
Alex Adair - Make Me Feel Better (Don Diablo & Cid Remix)
Deorro - Five Hours
Calvin Harris & John Newman - Blame (Acapella)
Ivan Gough & Feenixpawl - In My Mind (Axwell Remix)
Fedde Le Grand & Nicky Romero & Matthew Koma - Sparks (Vicetone Remix)
Rihanna - Where Have You Been (Cazzette Another Summery Hot Remix)
Eric Clapton - Cocaine (Koyote Bootleg)
Hardwell - Spaceman
Kaskade - Something Something Champs
Zedd & Foxes - Clarity (Vicetone Remix)
Bastille - Laura Palmer (Kat Krazy Remix)
Sander Van Doorn & Martin Garrix & DVBBS - Gold Skies (Elephante Remix)
Alesso - Heroes (Feat. Tove Lo) (Extended Mix)
Latch - You Are My Summer
Hardwell - Cobra (Official Energy Anthem 2012)
Mark Morrison - Return Of The Mack (Acapella)
Porter Robinson - The Seconds (feat. Jano) (Original Mix)
Bass Kleph - Keyboard Cat
Sash! - Ecuador (Wax Motif 2012 Wikileaks Remix)
Netsky - Puppy
Skrillex & The Doors - Breakn' A Sweat (Zedd Remix)
Galantis - The Heart That I'm Hearing (Original Mix)
Phoebe Ryan - Mine (Elephante Remix Extended)
Dirty South - Unbreakable (SNBRN Remix)
Daft Punk - One More Time
Daft Punk - Around The World (LP Version)
Duke Dumont & AME - Need U (100%) (Dave Edwards Remix)
Caribou - Can't Do Without You (Lenno Remix)
Enur feat. Natasja - Calabria (Club Mix)
Oliver Heldens & Becky Hill - Gecko (Overdrive) (Extended Edit)
DJ Snake vs Junior Senior - Move Your Feet (Parisian Vision)
A-Trak - Push (feat. Andrew Wyatt)
Say Lou Lou - Julian (The Chainsmokers Remix)
ASTR - Operate (The Chainsmokers Remix)
Syn Cole - Miami 82 (Vocal Mix)
Calvin Harris - Outside (feat. Ellie Goulding)
Reflekt - Need To Feel Loved (Adam K & Soha Vocal Mix)
Basto - Gregory's Theme (Extended Mix)
