Lorde - Tennis Court (Flume Remix)
Noosa - Walk On By (Sound Remedy Remix)
Daft Punk - Doin' it Right
DJ Marky and XRS - LK
Jakwob - Right Beside You (Etherwood Bootleg)
Sigma - Nobody to Love (Sigma's Future Jungle Mix)
Maduk - Never Again
Porter Robinson - Sad Machine
DJ Shadow - Midnight In Paris (Unknown Refix)
Ghost In The Shell - Uta 1 (Making of Cyborg)
Kill Paris - I Do Love You
Major Lazer - Lean On (feat. MÃ˜ & DJ Snake)
Arcade Fire - Sprawl II (Mountains Beyond Mountains)
Bjork - Bachelorette
Bassnectar - So Butterfly (2014 Version)
Montell Jordan - This Is How We Do It (Acappella)
INXS - Need You Tonight
Fine Young Cannibals - She Drives Me Crazy
Edward Sharpe & The Magnetic Zeros - Home (RAC Mix)
Odesza - Say My Name (feat. Zyra)
Haim - Falling (Duke Dumont Remix)
Michael Jackson - Man In The Mirror (Peer Kusiv & Rauschhhau Edit)
Gregory Porter - Liquid Spirit (Claptone Remix)
Xavier Rudd - Follow The Sun (Alex Cruz Remix)
Filous & Kitty Gorgi - Summer (Calvin Harris Cover)
Kaskade - It's You, It's Me (Marques Wyatt's Deep Interpretation Remix)
Klingande - Jubel (Original Mix)
Duke Dumont - I Got U (Kav Verhouzer Resouled Mix)
Sam Smith - Stay With Me (Throttle Remix)
Eric Prydz - Liberate (Original Mix)
Galantis - Help (Elephante Remix)
Madeon - The City (The M Machine Remix)
Feed Me & Crystal Fighters - Love Is All I Got (Original Mix)
DJ Ross & Marvin - Baker Street (Extended Mix)
Calvin Harris - Feel So Close (Extended Mix)
Neon Trees - Sleeping With A Friend (Kat Krazy Extended Mix)
Mat Zo & Porter Robinson - Easy (Extended Mix)
Avicii & Nicky Romero - I Could Be The One
