Atish - Peculiar Colors.alc
N'to - Starlings (Henry Saiz Remix).alc
Oovation - Falter (Juan Deminicis Remix).alc
Nora En Pure - Driving With Whales (Daniel Portman Remix).alc
Joshua - Watch Da Bass (Inland Knights Remix).alc
Purple Disco Machine - Walls.alc
Laid Back - Bakerman (Soul Clap Remix).alc
Andhim - Boy Boy Boy (Joris Voorn Remix).alc
Jimpster - Porchlight And Rocking Chairs (KiNK Remix).alc
Jessie Ware - Night Light (Joe Goddard Remix).alc
NVOY - Make You Mine.alc
Don Carlos - Alone (Paradise Version).alc
Jody Wisternoff feat. Sian Evans - The Bridge.alc
Way Out West - Tuesday Maybe.alc
Olivier Giacomotto - Bipolar Star.alc
Yotto - Fire Walk (Original Mix).alc
Worakls - When The Birds Go In The Wrong Way.alc
Booka Shade - Night Falls.alc
Brother Brown - Under The Water (Frankeepella).alc
Silicone Soul - Les Nocturnes.alc
DJ Tennis - Chirality (Plaid Remix).alc
Joeski - Kalimba.alc
Monkey Safari - Walls (Original Mix).alc
Dirk Sid Eno - Morgens In Odonien.alc
Doctor Dru - Praerie (Original Mix).alc
John Monkman & Pete Tong - Aurora.alc
Above & Beyond - Sticky Fingers (Lane 8 Remix).alc
Kaskade - Day Trippin' (feat. Estelle).alc
Wretch 32 - 6 Words (Nora En Pure Remix).alc
Marvin Gaye - How Sweet It Is (Eau Claire Remix).alc
Vicetone vs Bob Marley - Is This Love (Extended Mix).alc
The XX - Angels (Bodhi Remix).alc
Drake - Hold On, We're Going Home (TJR 120bpm Refix).alc
Solee - Sommerliebe (Eelke Kleijn Remix).alc
Khainz - Diagonal (Original Mix).alc
Eric Prydz - Generate (Kolsch Remix).alc
Say Lou Lou - Julian (The Chainsmokers Remix).alc
Avicii - Dear Boy.alc
Moby - Lift Me Up (Mylo Mix).alc
Basement Jaxx - Rendez-Vu.alc
Naxxos - New Orleans (Original Mix).alc
Smallpools - Dreaming (The Chainsmokers Remix).alc
Icona Pop - All Night.alc
Tove Lo - Not On Drugs.alc
Kortezman & Rozalla - Everybody's Free.alc
Avicii - You Make Me (Throttle Remix).alc
Dennis de Laat - Sound Of Violence (Main Mix).alc
REM - The Great Beyond (Hybrid Remix).alc
Calvin Harris - I Am Not Alone (Deadmau5 Remix).alc
Galantis - You (Extended Mix).als
Kaskade - Something Something Champs.alc
Noel Nanton - Your Love (Ian Pooley Summertime Mix).alc
The Magician - Sunlight (Elephante Remix).alc
Jam & Spoon - Find Me (Sally Shapiro Remix).alc
Bear Mountain - Faded (Natural Animal Remix).alc
Calvin Harris & Ellie Goulding - I Need Your Love (Acapella).als
Lorde - Team (Elephante Remix).alc
Rufus - Take Me (Cassian Remix).alc
Vijay & Sofia Zlatko - Wildest Dreams (Extended Mix).alc
Little Boots - New In Town (Fred Falke Remix).alc
Yotto - Wondering (feat. CAPS).alc
